11111111111111111111111111111111
10001100C000C01C0000001000000011
1010001000010101001C000011010001
100P0000101C000001C000101E000101
11111111111111111111111111111111