111111111111111111111
100000000C00001C00001
10100110111C100100001
100C000E1110000C00101
100000111100000C00101
111111101000000C00101
100P000000C00C0000101
111111111111111111111