111111111111111111111
100011000000001000E01
101000100001010000001
100P00001010000000101
111111111111111111111