111111111111111111111
100011000C00001000001
101000100001010000001
100P00001010C000C0101
111111111111111111111