111111111111111111111
100000000000E00000001
100000000000000000001
100P00000000C00000001
111111111111111111111