1111111111111111111111111111111111111111111111111111111111111111
100011000000E0000011000000E0000011000000E0000011000000E000001101
10100P0100000000100P0100000000100P0100000000100P0100010000100P01
100P00001010C0000P00001010C0000P00001010C0000P00001010C0000P0001
1111111111111111111111111111111111111111111111111111111111111111