1111111111111111111111111111111111111111111111111111111111111
1000P0000C0000000000000000000C0000000000000000C0000000000E001
1111111111111111111111111111111111111111111111111111111111111