1111111111111111
100000000010E001
1000010000000001
100P00A00010C001
1111111111111111