1111111111111111
100000000000E001
1000000000000001
100P00000000C001
1111111111111111
11111111