11111111111111111111111111111111111
100011000C00001000001000C0001000E01
1010C010000101000001C0000100C000001
100P00001010C00C00000000100000C0101
11111111111111111111111111111111111